$ANSIBLE_VAULT;1.1;AES256
61323938623264383461653763383361336235343539303937326162646437323030633661376638
3438323764666365333537363630636263343462613062350a386638376535323864383862636334
31366663663962633864623564333262623034646562666165363935343932366430366636383238
6536326139303738300a633038343738663066353231396137383764636365303734333661663636
62303538336138303130303638336339626466363439363837353166366366653830383338633466
37393966303865363035306465643738623737356463633234613137333231373634313164373265
38316331313236656663623465303733316532643762666135353537656637623938353564313332
35346564613762633437353931616439623532613030333436623238346164643835636535323439
63623839653565626365303537656466396332653037353634656232326336313639316132346433
63313935353437396662353032613935313263653833363361363934396536316637363239666663
61343733373564636437373431333265633463323631356562343264336630383362393664326230
37303963613630636630646163653936353963366532633162363761626631313130653362303338
33323261643564656634396232646230666139356366303664663765323630633964636434633432
64663632363361323763663434326530376436383038656634313566623663623230383434353665
36643337653265643631356139303138363461643465326235306635303565306436346564653234
33316133313734613937383935653061326632373764393130363164633766653930306466376537
36663535393533373638636534366365656461326561623332373163396534613330363361616138
33343831616538666439643764666161633265333233396261636661363262626532613337356534
37386330626136653738613837623536383761323432373535643165343235646661653236636165
30306466393763333035316361386632386166626261316537623264343138633135313962306362
34386438663634666332326133343537643431656435386638376361346535316461303239663736
34643834646634393035373532333635393236303333306534393566313666666236373466343639
63666339393465643365386131646339393362353530393362363735636565666236373734303264
34616335333765633436363161633762626166656234303264336366646335396333346133306364
62333130303266313533663937666264626135643264653464303237633765663635643938313136
34333531333164656564393933396136636330663535623933663837313462386638646231333238
63333261643232366130313833613434306463303737633338383439353934623065656464346432
63353663343833306266353862653832393361643563316336636137393237383133386266316163
32663966623835323862343763306664326364613361353361616663316333323233306238666133
39636437646466336131616263623839623865616138626361313062383564623566393665373931
34373164643330613464316561643438313539643331636265376465626366613937623762313833
33623437393364326634316335663862646239633239343966396262356637363931383735393066
31306631663966663064656532303437313663626138303466323161633439333263313366653530
64353463396365653530316562373264653039343966366365633764303738366663666637376666
34363862646338656238383663373964393466633034306534616436386436666563616266306362
33623766633465366461396438363738643664613137353635336538616338343633366266383835
62633561353835613963653766333831653634336539616338666463626331646230326161656534
38623731633036613462613439373234396263313839303733663165313438623966643131313139
38663134643631363631623735383561623435623830646636373432373131363030333039626666
33346162656461333465623562616431643535303232303839306636306235316434633363656232
65303834346435633531346666373835323330666262373466346137363563356238303161626538
36316565393438643765346434613730333063613332323033663837353265316337626563393461
65623835366136393130616530353161353536613338616466666437363831316265376263373331
66616639306538326537626236303666663666356231653531373638323030363365626366383734
31306430646136393764626537366337643166623266333839636633623461373338316138393565
31663630343965353666333764333638363164633962663966376666653038316564333930396663
62303763636365353463623061636133623562316334633536623736343364613731383834646431
32316536656233643863666230363233653464376536383431653738633437633662303039336663
61613764343562386462333062363538303138623235393461373737623830633833653763356562
30663366653832366633316166306433393064633833646432313561633663383739393765643230
32323365323937323938333738653365316232393734356631393961623663336566656636303733
64386465346564633030333566333534316465366465393362303964366435383735613631346637
33363335616164623430636132666165386234393761333565393330613131616562306661303964
61306237393361383061643163623339623838313565323231323061326562346539663731383364
32333330653839393034343766313130353864653530353131363731653863333835666633353762
61613938646162376562326133646561356536356364303638626437653461343066393934396634
38343965373237393361313663376436353434643664353731636266336137373632633062363766
64653138373434653031666131653034303065356131356166356266653165653437393862363930
31323334656236326134626437663933626264623939376435353561636666343364666363353835
39613339386664333030616432303131366531343362386663336134383663663163393265663363
34326463623030323831356335336232656437626139633566306264306166393530313363646531
64383130613633633565663537313263383738616336313362663264316239633934323566626264
36623234656539313533356336396365633438333761656431366132623661636138386565376266
63316465646664336438343861346463373030333134646137353238363165326437316633623430
31643533393738643239616133346266356664646365383832636566393937373563306634613432
65626138663736633130313333373133346463316632373036626361623866356332326332336434
37633338363433363564396335313032643664323861353233306131656635643332636433353032
63336631323633613433623866656461303331303036613338336361666239393533343230643366
64646133303330626531666664323734333163373633643133646634343564633537623436303465
66333264316532383636356465663966383538393861306164373762336630353032626565373836
34356436653633623231373062313062316362393163623163323633623266383138393132396633
63316335383236326335656265333466303739613461666336316637373839343732346663376237
37336465306537363965613561316435333836666435663933353030643731313265343462626438
65303536633632303262363636663938666164613733363036353063663332643865336130323834
35373532636330303338353664363362373766306436616238353733386130333366316537663130
61333331313439343066343736653465326132366535616566623034393436366531616466653235
30313966616662333464376564393338666163313731623030373537353235396435663031373831
36663130353264633961306162363639626366383131356336636632653461623632383561623632
32643839366131346163333037343035343463313837326563326231666464633764333861663632
63613136613561616163663834363362373432333337373339313036326566373839636665303063
63376261623633343764643632636530396432633766393837623238393464363033306133633731
38363236356565643133313238316132333865363761383730326263383765653430633230323564
66353063636636376138316638616563363339616539616665646665333331656235353931343666
35363131383339626266313831613230346338653963656234616238336631353836373032316639
31626135316637356163393266663030313766383965336232393764656631323661376431633632
31313064313435356630636563326536353632646631313733316465353133623430666536306161
31313937333433353437666238396165656536326532653738393166306632333537363262316265
33653333326164356339326232636466383466383261646433663465333039393639656238663031
32313438373437653734306364653637316166316332313865633133316239393934633336373934
63386535663631623863303239303466373963626265386632336436393830353930363339343764
65353939376163656633396434393037336263313934643161356637323535313435346331306566
62336461356566653136663661623439623936613362323361396565363939376135613065393864
38643336393735653239373030363663383065366564643532333432303031343633313865666534
34663961336634636330313233373661363639366631313837643763333034666133616539306531
34373336623634353439343961633638336165616635316137303438313963363935366166306238
63346339656161333739353734333438356561323737333633366436383334623431656662613032
62386338633365653636653161623039356166316636336534646662346235303062383931613638
33326337653164616236363136356662643230393163653832336532386234393536376464383836
65343063346237326663333461633834663364623161303963316438343530386539656362333339
63396531363331356239626430386132333364643965313063383061303362383636663737386562
63633532373331303138386433323232316361646431623932346266343564666334633663396231
63323263396232343936353933323161313534646162353638343037313932633466383863386136
30663731393261363033303238393735316339666163336238623130663232316464373538343965
61393433636261323433653236633238663763333333353436333163613433306533343637623730
32633331656164313765356363383731306134313935343263313039356335643865653239616262
66393166633337643732396335303334343462363432343836656533313161336437323539646439
33366638613833386337633133383437363236623764376438666261336666616633383038353963
64326330393636623636636132333036373162653462343662653736386131313066613130663035
33616237653533383339306535346266346364666433626134663466343566626432333034326463
31393038626233643430343461376237366535663734323237323435393365356161303139363534
62353831363839323761316331343430383463643365393836653166666334373165376630376632
30366532383963636137376266323966343036373737353161356438353231313761633138373936
61633332613037356363616235303239613939366337633431653438643337366530363039356536
39656665656139633736663166313762323566333139346234636564626331363230393034666237
37643532383832626165336437653536666364366165383832333064383139626632666463313330
33396162366334393937386532336136333834616436653163653661353762393866626533323930
34373061653439306530346561633734633465633337633033383331643337396466386565373739
38316139363162623233656333616266626138386338343161663866373162313535616531376364
63316533373261633033653961306638366230643763316664353137333537373931366166346639
36363766636131383863363532663539653439646133336236353133643834326131663330383961
65616665386537323065613130336136363730363938346336343861326364623437633638353035
30653664333437376234636239633030386163656165666533313137383466343863653538383866
66626331343861366263353661333135613564636563336665376363633937396633343364383633
36353036326438663935326262386630343735633962333264313434363330643834346663306435
31386638626565313436343730633164663062383330623238643334313064646131643432303265
37626263643632343539623833373465653538613532346430626262376666646239653938396234
31343539366534383632646639313763336433393032393536363931626234663263646535353065
64313165346432363264623836373631633363643237336231663636376330666337663234333138
35633039653331643166616538663232656161666238303030386163636333333030653832363663
64373966633131396233393837363637326132313238656633663833303631336535343130316434
66323737646231613261326664313739383065623038643731363461323366333862353836643965
66303538653761356530333931353832613733396630316137383932346665306338393130333365
33636631643066326465326634386339666465616330333333303335393265356437653839303037
65663831663038333635386231393932313830383337396130636437633334383332393165343033
66636432623761386662376462326139666662396232336132376134376263356133303432343438
30306336646135626165373630383962383764313461393361373062336364393330383039663466
34643832383234326638353832303933366437363666373834636164643336376234313534336165
62646431616139313161663764646262303666646663636363343135373931653364373566643539
39303834343339616566373437663965393961376235316263663865336264633635616665356365
63636262366664393034373830303061326361626163643431393436623535333133623161313938
38663332303062323365386330373337613038383834346233663163396433356537343833306561
65666434303539333832323962353336623033333161373635323939623466306234343335386435
35636532366561623930623934316535393130373763633936613063383435666162323139336566
66383863626364316439313066396564636634303032346666656564363230633164373264353935
38613163336533323434353936343262623535633533363062333636636363643262356337663631
63336363313766376430633936653631363563353462306237656537656333383634653935303661
32356333393565613362316462336433666432616433666336656633353364616464613865333765
33646337613631663362313161653065323637656430346462386462653234623636383562643730
33633861363235633733626133616261333363373736313066303235333061663465323938393162
38663161313331616432346139333633353138666263356330636237356535623266643938636538
66353566353137373266663338633933326262313362353838313233643265643136336238363831
66343238383435626132623162633031616434393565633739343133613632616638306338393866
33636333653334663536393231373337323263633537336139393830666265623436396630366337
35636337366265633436653363663138343063646233396561356335643335373834663335616661
30323164666533643933353238663863646534653064383131666635656664343130373738666665
39646564666530343065313864373136346435613339653134343637393536623665353166373362
64383162373563333432646563626132633735633162336339656566386364396230623030396664
32343862393061643435396263636235343565636235396362326234383937626362316134346261
61386431353031306438363562613730363263383338393336663861623932373535396463346639
65373033613061333030386137393437363636316533393439646137663262663365383838663139
61363463643138353437353962613064333030633362363663666463646162363161633430353661
33633732616330313139363939336538643039646636346438326239303731303531373134333338
36636634353635323531303234306436656632633435663162613231353631323334356539616534
37623165323035343862613364376264636139356337376237633438613666643937626266363330
30306566336230356537393837303533396161633932306634303465626239393665393865643166
33353562373630333861376562363731396534356230373362333639343138326534376332333365
37353534383337386533356364356531326231383763313261616266393031303465316165323530
30336537623037326163656562626566656162383834323830633330333764643864326534383062
61663234616662346233383666623839333438316439323539356339613234663662306263323936
62616635356231613237613132393337316335333032366561383962376266343366653137613865
36643065313233643937666463663736613238333437303866326561386236636163376434613562
62356135653231366432343864616138303863373566356430313236653335323531613138393961
33346431633366303333383733333531623033616664353936346434366364376662
