$ANSIBLE_VAULT;1.1;AES256
35613963396530383162623938633833316662383138356335396364313432333164353133316530
3564353535353364643263663131396661633863613164330a336165643930616432393738333566
36393036336265633763356531613461373233626236363562633263666133633039356130336262
6236313730633332350a633030663733396331613135303962616237643063653232643433316261
65623236626433393866326431653838613631616135383439393539393263356532386239666265
30343163613032353864663137326239343363646233353265323765346436316335306133306532
61636164356630303366626435366262343266336538303039316134346133353337323634316363
33353138386564623163323134356263326263383639393633316661653464393263386662303531
34396234346339623438396564343739323463653731306564313266376436396330633131656236
37363933303437666331363033633332343033393761303539393361613933316630333339636133
36633964353366386630623938613162303336363533613463613361623537643363323030333565
62303534343032336633666131353535303138396436343661636464633962343762646538626134
39663164623963376266633231303830346166626637656565313530333363613231656165626638
35663465333265623836343535653465333864633461333635336466323339343861656331306135
37363431313637393030303862623632393738633735313838636366663865356465386232626335
64353939656632316266643265663038626430633338316433626562653536613637346536353638
39663437323939626462643864383636613639363436353161663131616563646463303935313637
31623365363139383465366132663030663766643336623039383964613533666266393061356163
35386465393863663239363431323864623231366161333166646138313966636165336664633464
63383336653866363561373063663439626438313866356461616535333465353332653566663866
61333136616532663263376432326539333033633263653335383537353635386639623664366231
62386537373163623433666331343764353866346138313266343735663239343537333833336237
63396235643139386466303562653630623562646465633339373834336266373837666666643466
30303566396235373966633037313934633630396135613139306566383561313663373530633864
63616666636333366261653536626136383333396139636435623334616634363064383566393030
36633433623364326439653432616134386661346638653738333333383331396362366138383162
64313130336235326237663332656338316538616463363230323162336431336162653334373761
39356538336332646339343736383233353165383736666364306132353636356530393066613039
35313330303362326139336461336337313337633061376461343330343434613162366565376135
31333464633236313865346664616463303664653966663461343661363462346536353361646338
31663866646261303830636463396234336638383065393636383166633761363434393437633131
62616436323631623733313233666161616663653666623130323032663466633439613037306238
62366636386261626366376663366265616662373436306232633030366231303235363266333333
63306132336362373632303338663664636638663766356237376232636365333464366265386462
39616263663565623136616263323163303838336466316133643135303530363233323564643736
66373139656631653464396230623138643832396364313466313637373362383464633138656562
36316438366261393162616136363934656365323639656364336461393039336664356539663437
39613331353230633362663064363532643561653635363934383366303030343431303563633862
32666439386661303635363164663632363830366262626537623562323432386233353438636561
62313237313030633162343464336661316562643737626362633337353735616161643963396135
61633739323734326261346233316239383030323461383534616535353162613663356532376265
39323734663661336139303536356361393931393363643630383761643839346437653364373766
35373232373039306535616434356434333239333265636135393666323231316163383032313461
31626533636237303363303662633232636364623633656262346330653638666237356265323439
37643435633936653762636137663638316631626532323465346135313161313362313066306334
36616632656163396633333066393439336363386436633364373363336363666664303335656638
61643736323230323133373232333137323665653630373162646462366261303039343838613039
32303239313261316464653362316436353333623133353335346133323936366261663437623635
38666563323037653865663937663932303462613133643766653833643065643966636262623438
33323233303061646536633434316535306539313461643936316430663939356265653764303063
36633263613331663261363731393265663562393833343539633666303732303837393334663933
35656534653834303335356638363662656234613831613031313235396132356339363365616634
32336536653562663830623937313939336362363966323561616635616633353766623065376538
63363237323230663930613238663463353939626532376463353435343430313866313333623732
37653265626535356363343637353535313865343763386536656162396231623762653832666234
30333564656435633937316330356363626663303232326466373038653230633136653731363266
35366235616366373363336134346161666431313434613035383133326233663861643466653732
64633764333265636165663438353335366439646530313261626235613963373039313732306538
33366638323063303235393265353562653861333764356437656432356232313232613039643836
61356463383166643931653830353061633937623262366437643132613463623138393333376334
33306339343964646332383436386566396639363366363665313738623966376262333633663635
33616534376461366138656330313733363337613435636538626236336336346232386630633562
39316163306231303933386363643635323831666134313935656666626331393665656666653362
32613031376165303533313531306236363335353863663134336231313066356635666339626164
32643035666235333366346332643137643436366462326438386366366330306532663464313633
39656330623035396138326232336333636134616238316563643234353338396530303436313938
39613166363165383365353139623534363138336234396635356166373032393666313864346364
38336437316366316236623331656461663263383866646162346434386234313734653038386438
30366131326438633037316132306330616562336234633339626561376636643134333932626163
66646163313536343463323364656430393962333739353034383030633832393166656637366161
30353861336666356534653161623330313630663637383139306238383062633264393038306463
32343730643262313636333532636563383831383365313035666262303836333136386336396563
31343866666139633436636564386466656632646165303063656432383461363330363235353936
31313537626431616139343237313139313834623962623537653736343562363334656261383432
38343331646635313639373135666231666630373963383435376239373539313465393634393336
31623866666339373530383461306265313537613065663163336638356164656433663333653030
32653862336534346462333462333161613266633137353531363261646331613864623837313832
33323035306666356432326466656436316639303638626638666666333436633838333937323239
38303332373033303562633732333265323438373334393439616235333366393739356363626632
31303263353234613231346337316436616666393139653937663962373938393761343738343366
36353463633062663161633531623866393834663237373564313334393035366463633230323966
39633938383361323231376164613766323034633635376435656333393262306663316333353761
39383765643030386336366161613665616533636230306135326263353238616530303861613037
38356137333934633836633965336563326435363063336236653461373466666332396136316337
35386336653937666336383833666531333439613036323438386632623332633763643934666339
30363066323065646661353334353830333064356538626564323637323464616666633636636231
61353635383666366231656262313236323863396139623761376662303865366233363064633431
33396138643161393263333539656664633832636338323533353333663830343532353036396432
35616561336237333539366535363134623338356364653938373563323936666539323763346265
63336264666133656665343336656233666637353437626332353139623633383231646362313739
37613930373236386334636139663435313661316464616165363263653231373539336437353731
35613037383563346162306635663362623837366439663331633361376230376333333930613830
39343335623364383331353238313335626239393835386537666430383439353732353763636663
61323334643939393961666163306466653363643666383534643463393231613839616236343763
32666166323436633133386366663566613733333266336364316136326361393235633235633432
65633061396635393337346564306231656131656137656233383135613935633738666534366630
61353139393535643034323862333562323831316639616335653431626561343836383533633332
39323733393065333934363231353538626634363863393239326362366439643031646362303638
61656664666266313734353264333132383862653531323734356366653634393931623932366233
64323563633731343264336639383666303037326231653436303031326162303030643564623435
33373035373239353061636536366633326139623036633739653832366266666537663561306666
35383239303934343737396165616236376136616236393866323161623430653037306536316538
36633362393561313933623331613131363864333931333063306636346137643838363337396466
30373464643963633462663231356561656233363437666463663765323962356165353135633563
37363035353164316434303634326465333731353838333731373439313831316362386137346361
35353233396134643035386437393162663666626334633936373565343163303361663131623835
31616164666661666266396335663434326364663562346163366439666338653966323864393064
32616166653538613937643536313736373064366637383638623762343031616637663032643431
38626337653534306634616565666432376131653163643363353766633566353039306565303431
36306465376566313734323466633434666338356136323237643636616462393436363834386435
30363932323366306464333964363962646665343766656333643364613738333433613162663064
32623035333934313566326431323237323238373538613936336464306261626432656161303065
62343131373333363363386434343434383364383536346634633166376431613463613161326161
61303034613732333830643362373331646436623639396135373636643634653637343263396266
30333533656565383739393662613236303337356666323935353239333731376431643138356131
39303339623237303830626633633430343430323639663565663662383437366264383434316331
64363664313939626236326461303062666330666132386562653364386362643165643863643161
36656236323362386532376363313862633639643333633132313263326639373431366565306137
65363337623065306264643734396661656538333261336630343332353564353837326564633564
65666534646131623836333539363938333135653363383465393930653063363136373466313934
33373336323636363533333136626562363430316639323561313832366439663530643739376262
33666133663131363038383866663861356362336233623165323936666534643061306534383732
62323530313261363932346434313737333763636362396435613963623865343361366165623664
35666261663065616636343737633530316334636564303033376130303731303461656562636430
61353066323430356130633235633732313335386662313233326537333865633763383032383765
38616138353766393635326362366338323637356637326232396338356132376138643261333938
33346665386136656162626464316164386365656337303037363631646366356135346138623463
65376633363938666439653634623033313061646534366331346234646133373164636135653433
32643237633061313035303935653162373333303931336631346262623431613130393239663939
30623538333837643366343564336463663464323330326530666231383262333833653034356434
31656562386664633561646435343835383431376662353634323632313364343230326239363936
32346439376137653861316133613165616636363039333166396235343061303462373461663432
31313463656365633536316666323337663163363161616230356238643062326462396536633631
61346164656435336232616661663663366233626336353538646232623934356330363764386564
39646562666439366163653039353637623435316366663463633065336531643335646437666666
37666538613362386331366261653663333061646461346338666139626562396566663131616565
37373863376635383134366338626431623063396264653263393433323437333763646233303332
64323735616235353236666363623534393638616233356636646562373861656636623933313631
36623237326531616435396534663933373230653535323431646666366166386435646332613566
36346136336633363361326663626430336537616235396239313666626362656464323865313132
66626563386264316166663839663263663166333332613937376232633633363537316465343666
30313334346236326161303861323033633733653437356163336233386562323830663239633166
62343433663561363233356139626132343136663464323033613665656133393266653435656462
34386461656137356334376664393035643962363564333666336366333336353933336564346134
35333838353932386664303064326539333431373939353631636566356331346439646661623330
65336264326231316434363962326137643865636430303065343365333031633636333435303234
33623136343236343464373739633036363734613561303362633030616634336338366163326365
30393534663862386461636531366236326161393135366434333066366261633431313532313235
62333532643365633033373163623066613764353361663338326334303330626132353534306661
39643931343965313863373231343037626536376666333433336266356335306330373964346636
64313936343538613435623130626138326138633736653362356437626362663365643161346338
34356265613137323538393764633132623864616130303038383763643031326361313638646239
36363531346463366536383635626433643835653764306461663264353563303438363264333832
66356562396561363731313064383764643462653430613837333235323463316437653364383533
64623035623132653132653337313536333964303762646135336263343437396632363263636437
66666365393266333230396538373831363533323636653964653766343431326264383561356534
65613662353933643063373634636461663263326262613531656538383062346235643339306231
63363963656631636561323739346437393663613037386537326563616331656665613735646139
65613731323432353563636637333835343162386637656462303564373538663038356561313231
64643638613962623730646138373261393536663330633239326530653762383037623134633761
31346238313938376633313539343335653264393839356563363838323238633230326366613137
62383065386634393135663731646137613835623733366637313964376634616165353566306563
31346537643034353163623539343733353563323538383637333466643733663465353262356534
38363131613261613630626264313232613235663136333134376230616166316562333361316339
35623465376634343032623531666161373935663662346662626437393262626263343162303039
61353639636465623534316432366537333939386239343035366539323939303231653538323563
32656430303439653334356666633162636630376436383462653836383033333962303036323232
36313564333661383336613865393665636439373866373331646335393663383337623234376232
62306637346136663562373435643938363439316263373763653036626537313037313436343630
65343963653461636633373933623161333438373761323034393634303335643465393863343562
64653565336131326165666635633663346239616461643636623736653030303362613938646634
66353030343036326135616236663462313436393262623265353031336536333236343338376636
62343734646462633735356166386133333638623836313463666632316362633666
