$ANSIBLE_VAULT;1.1;AES256
38653965646337626435333261386630626134656237643737663635303866636439376537393962
3062663830376639613532616361303938383232626637330a366266666536613565373435306539
38396530323362663430663734336434316464363539393232393133393566303265336234636639
3830353965346266310a306136383061393465373231616638316539363062353461393632363736
62643934356463373662336266636565653630396631663436623031663863326335643930366566
36383530653262643362343139346439353739663331396465643766633034396133343436356166
65363563383963316231363364363665633630653034356634343561346564343633303237633063
35303262343435373731396265663235666530653866613031653334386137626238646630343466
37616433653132626437373061363938663564373366363164373139643764656337386161326137
37356537316131636533336432616163663037363762616334383032666561373562373833616438
31373466313034656365623739363864366330363235663837643461656539353563656537663836
65633137346434656438316531616164643735303664623933396139356565353931396137616236
34313835356433646563383736613734613634633532393863383765356134643564616237373832
39633765626133373161613338643464643032306637353434373766363431666430383936336665
34643262316662303863336464613661343133653537623638336432653332393332383333663839
36393837666437323838323830353265666362313930313135646638306337656137386361393137
38356635373039373637343461356464616539393065303438353665313161363331393239663139
66326563323338663834346236663035323232313236616463303735363332303231653234303565
37383930616432636464363362323831326231363464646535656630333766663734323734396133
64303232666265386635333536343039636432373130613930343363383862643533633436363437
36363166393433336361366339333036316564333566663664653736666661643362653562373963
65336364346635393765306138306263333266373865626333646133326632373430643466626265
66323635303461666231306566626630353961316130643262626334616562613334656432316639
62393032316265366231663838383536613066393765323539646565306163643263366539323836
31306562363138636639623666363634316466396464393936653236623838623164373637623037
61336136613263363639343532316534303965323861663130313963363062376639316434353735
63353634346133306336376565323338663366343830386533313764633335393936386333393261
33616466396466373036663631656139346133643534353234313135663336653530653234346363
35633634313864623964373938323738636662353561373935393531643832336637366537613465
39343063643165303663643931383238383331366430373431303662383637336530373862653437
38653662313932646336353266316561363031623463303566373366356464653661346433383137
62373763316365376361653430623331613737613438613733316362633734636365323532633233
30333462363831383134636531653566653139366635396134323061626663656336323837323965
36303433666437396162653936353162373061623238343866643766643137333433363561343032
33316462666530653032623964663464653935396536313837616662376231343636376265666562
66356139333937653465313266636432323234373530623539356631303762653630383231363931
62643665626133613365643036306335353865646562363961666431633662303930326664313235
62666233646363633064663339653337336233376163623236373363303537343862333231363061
63656232336664313233346163373363396464666534343130623064336537643339393533666566
36623163613936616266643663346663663830653765636663626432373465313335333331356431
36306164366639313464623336636137623432623362306639636532373266663232373566623464
33306463323061656438613930393462313838393731613466383738313234393564373566646339
33663034663632613436316132303235313061306265646365373833346533366239356331646434
37613634303131666430393138393665343863343031393861346239346336626363663461356338
64386131663862313337616566666566613135663437373161373733363536336234323936373765
38636632323462386138323466333139323265356564313332313033663834356530613438326461
39393932313132306435346136396364613065386661663263326538643234383437663132346639
64393235396132653239613537666366313762306564336137306239346435666539353264656261
36636462316634323265336337393334376332363461643562386539633337346238613463656130
64663662636165343831373339623437363237366332386130363464373731363963323965663734
64336162633738333237626339613130396665386630356537323134396332313438333539353236
62353563356365336436373066393566353537326634613235323031633561366238353763313033
37313165376330326665363562373661306266303334333363613366326565633366336533666665
33333239343064383861313231386630346566333337653036626535323636326538396538396661
34343535613366336161396638316362393938663735633936393262663134303664323139303734
35626263303636616161646233613564623635653865623234313762636434623634633661366634
32373964333632366362393231343164313437303832373564613861363966303065306464373162
62656163626266373132623465383533353232333930636337366166316565306463666666313561
39383764343563656133333166346264633132313735633430656334323663343861656335623036
30653466613561633034333538613333366638313433376130653166316462663336313164303735
33356266393665653731626563613063383032666336316131373634383963376564663131616633
31326531383365346637633963373038666263396631353964353462633266323534353236623539
63653330623830376165333839343862343762643165376561613965333836393132663339393336
35386138376330643066313764393630643637306632313432393738623232343132666538326161
61663563623934353766663733376664316361653937373533663766623436616135373836313733
33326361386233636137363632626666363739353635646533623761386264646130303938366535
33636632643034373137663464396165653930623937353936396435333364366337396531323765
63383063346130623234653235376365663465356137396539643733626666333035323939393339
34303136353938653165663163636235643638613737363266666363376337343464643464616464
66616166336263626538373932346433366664316332373338333662653630636334613031616539
39666466343062623566633730633966656266376439366437363833626133386137653061613764
35326637653965393430643738646130646137353463353438333632323438323439383639633230
61393837623737386464363437333336666437653830336161303830333164303363323138316132
35393961643933333536363630323063626537373632643763346265343231323437613331613431
35623566323931313232626239343564633061316232333439323730656462326364393934346134
34383366646339636330366338656439393939626665346138636163353236313431636332396632
35313036373038343531616436633864353935396361336532363266613631646564306433313964
30386335383130653063346330303837386634643862636138646264383934366339373765323064
65616131333665306331383833613861383165623831326665386135333766623064643630376234
32393137653166316262326561373262623464366664376662383439643063393034633761656666
30326563616563393935646263656631343932633035653238366463383561386362633238313165
65343438643437393663303937346262373537666637343033346566616362663331373363303639
32386166306432306166363532336537323332333731623065643539363566656434633832303132
34333465396339366161663336653037636432373966306232333565323834656361393537633761
62313064333130643765616362333565633830373539306330623261346335646534616632643961
62326433666365393063626164353831636661363937303331303465646363623536373066343563
64333665356564303539633831646537303463613566343632303465613266616439373939626437
61386139653730333835366538376435626536393133643866653363626237623861653731393537
65373964356334313038306335656163343966343764396466336461383130343166653263373031
37636565666239333232613863363365376464633338383966343330333234393738663837376236
32323634313330626662353265633166646464373062313061323835653638646635333839623166
37353034363330306561633561333761363630383832306139656639303431643361633134313732
35383163333930333961373966613033333033333965306365633436323064396337333034346630
35643331343566646131326335333664313365356466633634633861326132323336656437613562
35323663303739373863373563663533663338653461346233663363663337383939363163613761
33363064393635303136373661616238306137613431653965303662306537373561303637633734
37386535643437616564643530326233623766376461633437313032656233643932646265633737
62313162333361663863326236616261636462666439303338666637643063303062643434613231
30393135383037636363643735316634323534363234653165666432393731633864656134663831
66396163346263366261323262643633643130313935333137366435323537303139626561303736
65313030396465353561333161373461346635653230373563623133633363663234333166316130
30373635393438363239383035386134333362663332303736386532353236636438353539643561
62383332386231626234336634333363326235316636656166613162666134653764666431366432
65393865653865366537303537313462326164643666396538653263336561386235653462303736
32333838643533303564363765653766333032646436306530633361623431353863353430366636
37306261363533663563346338393238653839653262653838643236623361616561383737653764
36313133313831633039373134663932623865643737623638656436343939373661633666333631
34393262343233333932306539386430623535663738306438353831383366303632353331316334
33623230323133353261316137346139663739653264636538303938333135633665326564333538
35643438666132656430343436396533303165356463373431343461396262633362623766363735
32626261313439663862343932346432633531663362656639356139633939383164386434343065
61353364323365656465323466333761353231333061386464393130616333643764373839663264
33303664626233323561613936373731356231383136663233383031333836636161663538383339
65353933346562616532343632313266393733346562356339633931656138633231346366623836
66303739633037306461663738313430613731393835313363353836623563633263326333666262
39626138646433653530323830666338343635656335626561326565356537396236333533336166
61663534363831363239383466353262356231653062356439393239643761303533663435313132
34663738363234333434663632363536303733663137363639626665373233643063396132336332
61376466636364366437303035616463303736393765336562643833663965613863623937393937
61643263306631303337376437626562313462646661653433333763373962666339333766373232
31623235333062646432333935653431363964303039343631656536366362653430383962373031
33343033343238363238396638623139333364643738323030373933306164316634656461333563
63326437336234623532346230646261356632306535343235303232373831393335326666366630
63333564663835393331323861383030353464656531663063633239393634356464363361613839
38383337393262323862316630616133363832623062393134623336386561396132623864633235
65366262316237333339393261613930356666303363323537353732386265333165376131303265
35343436373465653239336138613736303737353137613566336432336635323930366333383238
39623465396334343136663633623666336664333465346331356261396534393536616266363263
31306435343764633366653731663736363261313639366134313732656361616238346338346431
30653862626131643032313633373739633163666631343331333031386531663464636262363732
65313665643332643637646632376431343635353634366338633139356435306162643861333139
37616631343535663436626230373363656335656630633536656565336537333837313431626638
61353862356130343865636339653037636530386332386265306264663835393731616330643735
62623930333236396263646432386332323033323433323564656539353531353164316637323563
30323636613231636635356165626137663735666566663861363239323733656237656233646634
32353961313063636539373463323535383934663661666137383934656664636136643661383832
65663162653837613837656261383237626261663261653266356532353265646531303665313834
33643664336364383533396237646531383666656435376330313530326262376130393664393436
31353338323164303738656139353763666561633433343064396638383030313533326461323439
66383336633238313937353164393332346131303238333032666230313335386464313266653565
31373662623063333061306231336633623639666462356234396235303761626131316164386365
35643664633062643134616631326238313161366632343364393536383636343039303563623663
63383939376438643164316639383761656531326161663835623736663539643631663762306131
39313836643766633534346637326461303136373363643831613036363862343737323264303734
64306339373739353833343735333666636135386130303266356663646339663132613332626232
38353665663930353463343536666137313461343437303066343363623065356238626633383930
39656638376463366539336438656137306438343966636238373734306261343035613964383030
32356665343337653034653066343736366166653862326266303163303764646239626165373337
35663164356339633033663666363439363234656565313633623334346665663338666366386233
66343634376131393030363964303366316661333435663032303033613937346366656263623031
37323832643939336438643563343361333164363230343964636466396638623061313539393436
35636635643733363763346632343865643137373565323966653763393862646234386132353539
62323065336662366137663738623561313835383037663839356464373534643165623361346433
35373563623234653633316564393365663339363330316566643236383632306263313465363565
36636531633164396339313738356330353331303232373664383966623264626362393036386430
30663331393632666565373864393935613930366661653266643937326365363435643131346338
62393064633866303936346537323231373931313133663832393461396262393430346639656132
61366334633163396530373331616535393566643534323061363164663739313766353430363835
35626264663532356130613334366435336431383630636166393866326234393937303831393030
62643164316265303962343061333463636565393232636166646636643031373137326636336139
37306163363936303366356233303638303439386430646531666538623833363432386164333234
32313766356562643166333631656234616631636534353932316462323130646233343365393030
32336664633765653532376237373561353538383737393063663834346636376431643261653637
39313863393133383062313933396131313030363930643032313533393930623730326164323939
31623936616365373635343064333433633565356539646165653232636139626431626136626263
35386666353132393530336563643965313330616630396462363464393266666638613261303165
34373966336436316565316235376236386263643062323230613036303037613430323131363930
34623037663935343938326436633231373466336231343561643234343765353165376663666234
36306462336534336166346264656538333635643061356534396463633635663537323239316261
62323232363664333638376539366430383537343466373039623265313265396231326366303033
65623336386134353134613235363637346437316266643431636434313134393261646139663531
39376663323032346432663939643535316630393831663031613062323132323664383563306638
36623433643161373365666165636333643032623163313630643563653639656264
