$ANSIBLE_VAULT;1.1;AES256
32623166333165326261653734376234336435313133346364383534313066343165663134616632
3434613438356262303035653864303638383066386438610a383137396238636331303335353366
35646165616234316562303732656232623635643733383264356563653438383439323466303563
6664363563396466340a306461346535623461656463333238633134626263376436303332666466
62363331633232333330666261623861373135666666386235346239376464643133306232323032
36306161303235393665313063616238396365633562383131373861643431636132616664393931
34313031376361353361643763356631626566346564653438653863616235306335336363393661
31613232366132646563376239353732613963333031313938366366663639396261636237656664
63666266396264326533623934646265616638323036616461613138376334366439393463373035
62656335353231393565303337343333393537333137323135383262353233656465353434343066
62633665303831363764316430343464313764316631366238646633336531373439383463653430
38396538363034306137613731326237383061643535333635373930313239323465323833656563
38356364353531646131376466356364613338373437383562343938663832393064373165393830
66313964353864653638643465366436653930363463626135353933353534623237343739356166
38656632333963303261346562613134393436333562663565626532333862326435653662326536
64373734383632616366313933356432326131656536393638306265383463313539623766333165
66663330363265666232306332386331336136653932333931653738356263353666353562363832
63666137313233363366623234343763333238336539393563636336366433666236323937353038
32646163366637393664656435656137333761623838343734383839313262373736633532333430
32326336656661306663653432323765633130383761656531323537396461346437656631616566
31343633663062653038353337666335376363666131356334623930373836666634306463363135
36653762343838346632323535623632386331316266323239653135653462313338306632666536
38366562383832386665663135333932326438626665666434343263326533343065356466366633
66623831343130653930633530336433326438396137336161666665623537383666623738636431
63393862616235663766306438313739306137363261623539366237623736653237323932383664
64356363636334336532656163396430643632343137643262396631343333376661333465633565
62363262336336326263346233656434613432323330653432383238633536663732346338363963
36303565653266656232316638626433343633643435653232393033376563383630653036353936
37366133353934646438313033313539326263626639633932623163373063393437663335393261
63346633653930326332653733313765626430393863633432343533393937373039363463646161
63616439303737376138316566646266316334666231333935656336366138336330616335386365
36393838333463636239613430323336663362343539373361366633396364326662653366663164
61376630303230313761333030303933383538623130303364313734343564313662633533353165
38613831323765366663623265356130303539326663396137313437333633336435323031663032
31393537623537613862303566323862333531396365613232303338343035663236636433343666
65303733333132396135303431626631383866363336636562333163373661303332373538643736
33366466613266636330666332333235303838336430306230323431326139353135623631653432
32646236343435633262636562656663623964346463313537633664343464653363393666633532
34333866356337336261656632663064323636306132383333303835353531336339626436623038
32663565613363376130653330323630653434343062303835323861653035363264646266326230
38303739353832353461633435663466613537663933333462306462346130336538323465356332
64363534373830613039626239333730663131363130356362326237613765316163316532323464
37353361633434643735326130636466303232656331383663623564656435646537666466373861
37623164633636323833366462646666393639636537383838336635623664353735336234363932
31343064336366656432363037646662303366636462323733313431636135333434366238653631
31386632363562326233363237363639363862653432613565376462613465393934326436373363
61616566323361663765386565313437313534643965623661663735346665336330663261316532
30303733363961666339383664396562383066636139663133336132393635656334636631613234
37663335356130383661643733656565356465306330373036326162613066373334343262316536
37343030346563323538386363643738353466656233633834303166323937613237653864326330
37343932303234636661356466663138343338303338653535643965313234323038633564623235
36343637653064343562656132306664643363346131306563626533653363343065663038323236
38313664343963356338396539663861376237633533373061343766643966623162616339663639
39643565363830613738663335346530313634646137346233346535316165663966616130666638
64333362366365613235616463393362326431303339316631323361313261663433343038363331
65663762343532643636646363343037653835373733626232326433633963643365336465326264
30613638333766343630356536646330353936616534663132313566356262313762316363373935
62653161636462356665646666336231363533663435343064333561386463316361333733623239
39396566383133646237316264393537373834643561613435363365333466336639323932393135
36373163646663613532613963666164323436636266643930363838336532333039303166373634
35613561616630636430613461656164653738353836383566663435626635336337323834363064
61313933343361663561353761643234643334303863666166626663626365326663366237393730
38333533373234653166656661366462633663323266333530343736393464653236666364386631
31323461623664323765343763386661353934343836626636333432373262376134393932303435
63353936336564353932333034333163653534653361653739333039356434653639366234393631
38393433393330656566393061623533363036353263343139613035633739623864303063356536
30326231366139383935623936656663396363643866333063313464623461336138666461633131
66306335346566323830323034343433656338616233323731373333393832373532333066373239
37316361633638343034666432643263616536366564356465636539343866353739386333313862
66336664346137393037393733303039633039613666633536353632376562636534313130363062
35643537323263616362333161666665343065393263316435323730333964323466646163663166
62313034326130373230333862353435383538336363303439633533383931633033333231623565
36316336333532623436343133393438383432623933343135613363643161316463633035643563
32383835393262666131633835653833663065353665343635366138303566343430666232343765
62323032373839353437326338353238393135333432626262383566643566636432316539383538
34626161353435626366623532336136633362353437323936666266376231383830366539373732
35616261656332386161633230356565356464386337343064313462323733353365333231353239
39313239616236303366623361333165613861336663396362643263663366346664623434653134
33353965323731313064636561343931613239363265303539623063303133383864366466643338
62643963316133323834353366363136646166333662653866613631393964353930383062333766
33646435373133653765313630393936323165373863626539303834653134353265376433336433
38623863616161343166333632306630323961613336353838303063643564363033656162633430
36616534366362656236373666333234336630343534656135303834616235643638383761376230
34356635306164303432653730333532393966303530303139363136393162323631633939643065
35303666393034313832366335363131666632313538663535616334316438366230653835616266
35303537623263636137353461386435346333303035623461306531646261653066363037343839
66366239393762613733376430316538303466343336623438666165326334613435383839356438
39343935326138343734343336343535616166636265623566326334333366333431386562333864
63646661323932313735393239623031376636646434383163643333393334643936383139616232
32663437323234383939323634363563366536643565306431613362643033323631356339353064
35663566373764346133366364643535363466393634653666323664383762306266316638613030
61393838653030663832356432666434613230323232343563303838336465653262376239623336
62363861633936633232663532346334343238363037383265313863313835613265303834343532
61303935383835663135333134363964386664356234306165376564303536393064333266336238
37386536623138643330623932316263306666616339643765363561313136623437636337643166
37336337393663353039313738393437373262623365366263623738636361346238383730643837
61626135323635313732653166306639386139336635646163623130643564333736636266653833
63316237353564323531616431616237323638346266393433613636323661366336623363306161
64366236386165626132306139323437616234663631663862636538653865303834393666653362
38383966383263346163666136623933613838646534613237626561326634356162383664343835
31313630383737626538313766646238363865613436343630306363343933366533353261346531
37356335393035336137316562623630313864616562646236653266666532316134326333323931
35623261353732623933386262393863613163393338326434323434616434316462333265363837
65383637623464356265393264313633363432643631386265353935663132613533383339643861
33666331353434313663623563313963366562373434323336616434356266663235613437313662
31643165333862666162656532393466613038343466626661363635653861633564666434356236
64633630646561343061373561383365613934376537323563353138643037353261313834383830
64616565343432616631363736653361363964313265613437356666393731393632663263333739
33346132313438383737633432663633633163303239363634633464363466663434633463303338
32353436376263626561303565313363336137326464353330366333376162376334643834666137
34303230376666666166366566323266323530343333626137343662636139323938646633393634
38393761646563346530663163653335653266363562343565623261356566656535393265636231
30333334336336393332646139636235643235666430636130663833623766353734393366386532
66373864633638376364666133616537316537663836646466323264363065326631646538386261
63353266383662646533343134623230326533336439333137333134376366346266626432623138
31663565303038613234383264663766646665383161393339313439353938366265663566346630
64336666333434626536313238396136646563313465326138313935666366633566366239653263
61636163616439363636313132336430316331373534323639313134656536393936316463636466
61643035386135303363613136613932323563666639656635373162323138623331333234623138
61666435323837313631383963663836663031646233326265653333646233643137373832666239
65653863326262653963356363646333323961316332306330356332663164653437386139323437
61306362636131396365356335666335333362646231633563666366313632376532633434653532
30656362666461353837343136313761306436643465633263356337663534363261303936313963
61383333323762313939363030393130323838643931343864323638303537653138346538353331
34316333353164363937623830346563663333643337633139303033393362393762663664336366
31326463643138316534663235326131326337326231623466306432333237633361663765336564
30623562346232323233633030356366366464636334336365336539613132653963353962643633
65333164386330336462333433373761313231613831303064653932343663613639613635323031
62653233646664333862626434636466326666626539636135373364613436336463376661353433
34626533356264383362633863633230633366616164356239636563613331666366343266653636
34623233316434623231343835356166633061393663333565353662636533373932356632303331
34356337356365366134633634316365303936343236373762336132396166316562333061356330
32313330386661623031643532346266643765336639633834623565333632346563323437626234
61636430656133613863343165643837636637333366626665366161333462303361306361326564
61346166303266313038663630336533393966343931623762356331653039393066383234376630
37303734633739656433313638393733323233346161343939613230303363356633613865393031
32643365636165623161636534376139653461306463623162633564623435633963323038366634
62356531386634653138393962303861666635313433323439343330643466666466393230323232
38663965303762623538303763393932353532333339346662313834346365373437666330363437
32656531626563346636636335353835316566643263643839666332666664346132353831643562
36313566356364323935656461653365363037323031366661343036353164626637363338636634
61396665656432643131646536383238616664353835383239376231386530633265643834396662
36633537353764633830656137346664383330653438346464336133326232663566316633343631
66336435336231343864336563313436303036613538376263336538626634373665666265373634
65326639653338653162333937636139313539653134306639643031343166623031666435306232
37353764303238393333313665323461663534373265636562383231306537383761306236383434
31666432633831353338663038613661333264396364363261646637373437333838323161646139
33366665356635616437656535653634613265653763323665363237613732653036393430303966
62636663633361346362633564323832636635646139333536386332323435666366663063366430
66626561376363333836666533613065666335343537313463333239663437616361383863353937
63333032366230636132303962346539356139373530376336636261373365373737613130343761
30666262633832656161396162646637336630366565613736643666303866313962656165643164
65396634613462666137303965633538636632653264333664666663353934383866346233316531
64633630303633333831376137313739613734383865643637393530316531353031313638646334
61626163346335306231616234633563356134333062343434333432623032373532613431366437
35383666326232363235623332353334373038663630313666396164663137343466396534363339
35343366643762663363643263613732383264623930393364333739613534656335323131336331
31643939643238316530633230366632643934666661653866616139633633633334363136353730
34376264383539373435666364653430366230386466633439396336626132313861323337633138
34323762303232393966623734626266353034313961333738393531363566633266336230633561
33633137643761316364646134306162323138636535336537386438366233353538316535333265
65326237393230663935326661346330393233616438306361376364363933333138613166336538
66666534383433373565396335653538336433633632323230616633653863613830666666626365
64613130346164663132343561633139623332383034396466316661383462373631336539393066
39356630363138313532656463306365623062613734303965646436383930336562316438646337
39336137316336386235663138353563633731343339356161633538323464313734303365333635
61363532303864366138306231393739323164373162363862626366346566383533343338313562
33393064656264653937313765376230363730663031646263313434383665393335386630393334
64613765616632303763326535653537636364363334366663636464643265393262323930613039
34313332383032323736643065356232386436663665626464383961336531353632346632373831
30656132343631383031656362393435396162396632626132363737663262383939343131656166
63303433333963306537333832623435376563373638663830643031303334666531373334646336
37333436613937313931383039386634623234396631366165373064343734383762
