$ANSIBLE_VAULT;1.1;AES256
64616631643935366539336235303333653738623364636335393838613034366365346631313938
3137613636396235363130663035653432353263363137610a383935646166343463613433663334
63306331653462613165633734316561353730396364356366663631373436633862303537353730
6663636666303532610a376231333634623932333032303833316137656131623437336665396434
38386363623039623133383664333733313462303163653739626663646232626636343033383962
63363931306237393032613932653666373963353264306562666463643431366431313432356532
39353633666130303562633964343263616661366536346637383137316138313264633936643538
36346339616461643837363232303862383938613833623936646635336166636163373531626365
65366632643132376565656331396235333732313562386262336664316139663138353933303364
63636235616130373962646263616337336462306232326534656232653964623431323233303862
32303336636465626637346139396666323736373361393362323734366464366364393065396137
33623266363534346362343562353231383362313861386233346631633436316539393032313434
33303562343366663239326265393863383561623634646331393764323137616138353231316534
33333161626566653833626465303866393561333539333336666538343066663335663363366331
62306234393161646232323937666138303237303066303061303364393262346564666637313631
61623432366463363166333036666235316662653037613631303264393863636438383239653437
33373862663036363238303163306364343133306539636464626330363766646263623138306433
65333866613565666664653133353230643433393762336435656132646131656130363433323661
35616261343362373732323834653565653138663235623438616462626633393962316638633731
39366331666638626330396635663461313538343234326431663736333366343734653337346539
62363965626162663236393834346434363235313031666539663734643133363765376235346163
64366565383965353964646564326237383562626132623564316131396632643861666138623131
62383734373164666536303266613936393262333232303438653037626533656535363066633665
66323763373561636631343430333333343461306665626435343439333538386632386439366537
61393132373466316463373031373035303335616437393236643663663063323663303335646633
63386431656638303937663865376230393730326438663266396366396361333832643337666438
62653035356634646263646232316639373334636265623766633761356430313739363138376532
37643738653365653939663636363365636139323230343239326562353934643934386263393431
63663330633366643166376663663436333363636366303865386135333865636134666431316565
39346663343139636261343432383930346462623066353833313563363665623136323165346161
30326562303066653238366432646234383863316537653238633166356266383638396462386365
37653138663438323534373339653461313239323062633561336432356435643133366135646161
61343764613062653335313665356538643963363766666334316466663931356363336165646131
38373863636462643335323966666166653631353639646162386439396264336334373264333333
32383638623139613532316532643633353631316136323139613438386331346564346261303466
36663639373235646537376134376561333935623461363539306235393037336562386636663966
63393630656337336432346139363132316563633461383537356462316161633932323962306435
35323362636634386232346335663834303534376464616464333536336664666666346133393262
65396537666466396365376235643061373830386335656162316438643130626662373064373836
64383030353932353963373638313630313364623438653238616162613064373064376238653131
38306533356337346563363731306465396230363734393265626661306538633535306433623338
61616638323332636363336331393166623131313830346436616264313437656432316362383064
34613232626662333766633936393466653738333831383738363964613935386266626135613038
66626363313034386362633433666135396236383736623262356230663061316561316133343536
31316333303565323330346435643237623633626138653566663538616163643939386639326562
35393931636662393735356538616130313661646234373433353036376565653530656662316136
33396439313431616131313638366562333839333336626630643038376437373136393263656565
32343566633033376134323832323264613438393461613639646531646438623630313433373761
34373135616364653732616238666266653032376565396161396133333063353238643533636337
30353236393238396666653464376234373235373631306365616437336334323631623031303732
66653062663464353861333565646632393338386235653764613062303164366531633662666463
38666235326239383864366132373232303733366130343963373463643439386538646464313935
63656532653736613730363933323633323364346131343464343332633163313563643639313433
32666436323134346238653161303136346666623034353531373265303738623663613030643530
31373861393164633066663862316433326661363062633933366537386536303661356438613763
31613761333465393938383766383536353166353061386538383337373865336162356131366534
33383061353639336165383163666330663933616430623662636431396339323264656335333331
64343263646362393433616665373634636232343339303137396534366332356233656530376364
63666562313533343039303336313030616533323631636532633261343162313337666638343337
32613332663435356366623634353966346435396634326436623664333038386437343664366538
30646663383764323163666630653861393237303266323663343032343064623661363638633239
33633663393666393733396264373737383131306630653938343936616332393963656565393439
38356262343335613733313666303533306262353762366434343762353334356332613963653761
35306338343437396437636161356530313334336162396235636539626365383761346436343836
39633865336134646237333661633937616639636233306633376639383365666636383862653631
31643662636366363933656264306464646661366334333730396366316634366561343732356661
39613534363065636530623666386365383364356235653936366565393933613863626465383863
30363763613439316163613535316566653739666363636535383539613461636462643132376366
35373866316661336539636262626633383333613964616565323134363631343336373333306537
66616566363734653364373666326230393930393362306535633839663566633138386436623535
32653338343731366333316638386231323532303435306339336264646661636263643864663030
36333231663230653536613163353237626533643931396639663534306461653561616633613438
38656434333562343964616233353930316261346463646563633437393764343536373134306136
35323166653732626538393261396534333730623039376262613132656339393566653331616466
33613739323963323764383438326635316164393236633737636331383464643638396661323036
64313532626530353137663537643739626132356166626538313036323136303439373236316334
34666362396637353965646164626430356637303133633232396130666238373039643933323839
65653233303364666634366433386666383835373066393764396165303732333861656332613266
64383739336530656634303131353835333136376663326334346533306361636438653564633338
63336262633533653434366161616565356535643164623231393262303334616535653665326465
39646664653962346163396332633762653935613937643061373036333634373636333135316136
62313263333361303033383162313232323063656666396530653863303337636266386139363933
66386336323832633662346139316463356566356536666362316534346537373530376466316161
66363035623866663731653662333532643866306166313439613163356432623461656331383661
37333430356564376436636437383762393435363062326238613235393030636239663039333238
39383830363761633366386535306136346531356364643534316632373464623536633430333838
66383937363361663964633966666636316232636232653861636536376632393733303535363238
35396431363038663862653436636437643865396436333136663537643061333239663464353832
34313730663930393031376364636263633864353937626239306464633136663064343861396636
65373961346338373032626434623937336563623833353263313636633266373639633864316532
66656232363064343632333932363335343233626239663832366335393862306162636532393233
30393634663162613461303766653963323436333733343937336464303238643965653338623230
66326333656637323031623438343462646337643563663133313861376637326638326263323231
34313236636165656366663235353461623264303366616232343265323234303961316264646237
64306337343564663465386565363939663431346432646430333262356234663938323230653232
62386261666164306165653538316666303264393933633966343962343431626163633236363262
66616639396134323932333636616466346630623932333466306334313836363436303261303634
66633264326333663133626631643134303734663635366136353237373232623336333433363565
34336438333331396338306161343239653934373636303239326437356162396363366535343635
39376437366237356338663666393035633463613263363663656466336235316364346165326533
34613162346265663936323235306639636434386333366263316162656537366466666665383462
62623664656438336466383463623662646237636463643432633338396339306233363934313438
34653938663265323762663863363261623839633236386636393030336135613236643334303637
38653163326531323433363461653562363261623236633563623832663331306433666563376239
65353339383362666230643434383536303865626439316363336365353063646463363465376139
64306335333932353265353139386263396235383031646338613437636237313264343965633234
32386333356532323534656163373463323662663663376135326333616634393430653134303464
30666535323162303635393566373335383566623232336262623833613965666361623435623239
33666531386230313766343564663866316638623433623263353463313964336334363363336236
62653936633662383831333661373532646531323334353731323664346135663333316565353235
34636563653562663364653430363330303633663030643435316430366164343839643065303161
31343034646637636532653131326564333337353038323633326638376365666434343438323630
66613564633539633237653735323339376533393930336538636235373566646431356431396564
65373235636564303835356636343165316666303363613237336534636563326636363438343033
64383135623535333031653533663662326432353331346535613565356238303035353563353463
65383431376466666433666362373065616138313732323066623833323465396632326237303434
64613431656163333661623234396431313535373961313937386662666430643236613866366664
65346564626562633733306163343563663439616164346462316439306531343934666464303366
31396465663462333365653961326230333165613937333538346136313662363738343665373965
36663635326535366232656163323230353138376234643636353561616234383263613964373739
33653534353163363332353033616331643061386630383965336136386333326432303039383430
63626661313966386466366266396163363963616231336136393866393038383363653838313137
65616234336164306134343830626530626438326566613161643239626266303466326664383338
30373466303764346162663432393964613334303066373065663439666166363539313835356237
36366365346261616565656363666465303532616530323565373833663639663265656363316665
39323065623663656131616533653835663234373565643036653731656364376637366636353833
36663632343464623832303235636664333764626236626461653330646665633132353938313935
37666263383763396264386139323862333230633338623638376664373732316639643630633933
32666664333332306231346239663532656564373332653238356537663438663738663134303931
64333963613464396238653064646332326266323135323461373934356637396566323661353331
31363261376361663164336239666364386562633033653963636136663762333232353362383335
62373038393664623862396666616531633161353361323531303438303237613136316266623466
32616261363439616135333736653965386131393762623333303637393339393034373232363532
63643763626635663361333963653938353033663136383535373033353435643462313630303935
36626166366632653866653865613536353931353638316436663439356534623138373432303639
34643865343034633832353262633833313931643665383362623261373261323937663739366663
61383438633634633038313863303463613365373435303537653662623564316334623064626164
34373432393964643264623238646533613665336634623139336262383830666330333934336235
38646330343762383739613163333236346135656339643564346132663733666533623264306263
66323465373331353036306565613237326333633731633731336336393237643331356665636632
66303735383839373561376533653537356138646264323236393330373938616135333539313566
37386265396262373933306464393833346138633863643835383630393233363630373536616332
39633934653734333236326361356433326439666362313133353331646661366232643966353162
35376265343132663435613131386130376234626435316164346165316337666637353437663566
35373266663731363462613430336262373238353331376263336262653831333933656635613265
66336565303332343330333761643130383031643830656134653839343939636530333663643264
62646535636361333163613239646164303639353937353561373138393462633634363131303166
32373834343933666566303066643661643338303230663539396235353365323439326462663663
32313737393463353366343230376132363632336665303434623234316539373662623937313830
61353931313464356234383632376130646338333636393231313963303864396435623732383634
39353364326534386235303464643466656266336438623937343430363130653962303330353033
36383464343034356235393730393139383333323630303663363937323138633365656539363738
31303139623663326365646364323134323833303662303732363238363064373062343635653238
39356265326339396331316463366262663232363163316335663038393934363438336332316532
32326662653131643336333037336463376465356631633335373432636130653438363164623463
35393063663432373332386432323966316135626466643136393136333432643061373965663130
30373362643532376237353163393766373165366438373866623235396164386664646538363263
65383065363936623931363961613539373362626639643031356364306363326431333634363138
34663664646131646131383435316237656636393265393939366365386565306265663866653632
38626539306631633531313635383637323035386135636532363831366432653934643365313735
35613465646661613836373836626663343764343533633363323065313066616464306561363166
33393437633766313065313531356661316239396165353161616330363166383366316638373663
66353163353431303838313337656636333265643565656139343932373336373737303137653864
34633639363562653738383366373735623231383630386131353164613936303935383463636263
30353939383832653232623831363932333331306135373565333136366339383234356136653964
66353763653236353662326463396662343139636161353630323766653432653037633533383965
65343739313534343464353539333764376237373436656664393833396331653439346532663433
66306637363534346362613336383664316462346166623966363134333935646166616637353436
30326333626237643464396638396632383633303135643435363638646565306566313464626563
37626463373766633038623236336361663562353766623864353432653134623438613864363130
36346333363538373066323633636530623261366638363066383835373063323562663136623230
30613364643437396336666637633639356662626465646462616633323631386533613839336366
37393737393137343230386338663534613863663765636130643735623463336437
