$ANSIBLE_VAULT;1.1;AES256
30613536333961633835356535333933666435386238343638366665613133366532373236663766
3731666464343663633862343865633439393938666235640a623265303032386438666365383364
31306434313531306536363935636534353366613738333161396531343635343230666361653739
3839613531373936370a656336386162383263643530633432646433396661633564623437666661
35316133666236356262363164323364306131396232383963633033363237623834653662366432
37313334353733613432343734363861343264643866393464313936613865346132623433366463
65366135616131653039626437343730313036363166616132623562326436386264383731316562
32623134373334306664343061373133303836303237323134336539353933646539303462373831
35303162383838383038333562613564336531613266623634323565326438633463333433376134
31303033646630643331343135343036623433633032656664323439393733353737396432636265
33303235303635303264316163353531303762316464346163383863633365633436363339383031
33653866623930623137623634346466363763626137353939666434623334323733633661323965
37303665666332623232386533356439333235353765656166313237313036613963653230613362
64386561346561666237623831616336333966613537643531623866303637356231356230666264
66623231393231613065353065613461323666323234323561636162333131363163303132616233
61393766616163663738616431343963303563383061653635623339646637653735663866613831
37373566663332646266626534353035396536613836666137386238386166376265373731383531
61373661643361336233356664323137333464396662326235613665643665326461623465386539
63373137643462356338393562303065643237363334323633393839663961616336373339616437
32393130323836663634626165626166343730343234623965366638383037363032313761303231
37386163623139366562376532633335646338316238653034383836373335666564383733316231
34373930303663653231306139656238373134656465393265373134356463626138343865303432
36393930313939306133336366643538666165333830323464356262633266326264623835653333
38616663626464303036646265306430326433316364303934353130353565643134646161393533
66343131313830326463383361653063353731386236393563346665663764346337666362623161
31346330366235356137353465323434366237656334346662623737313036646432333962656139
34643638633434646438353835623335623632316137393362643037393163386537353266623038
38646333373233353639323131653731663330383736613133626263313031306236356431623938
64363733653031326434653733333361356130643132633932346337383930396262663138343137
63376134373739656232323963653439636335393938633564396663633535643532343064656661
38316336393730393166623663396132653734666232383333353363663335333639313261393135
31613833613533633464343138356431393264386661356234323039353934356130333831356563
31316631376261663866656531313334333136346362653666323661656466303933643534386166
63643239633231343630663264383831356538323731353762346563313030363061616161303334
61366333386638393137656130636438316532623533366636626639656166336663343166343131
33376462386536633538396439386465613132623462643663636264393230636665643364343034
34653337626235666330383437303461366562623836396335336635333335386539333837323738
39656464353165346131336134646162323430643766663531643362366139326363366138336436
34636532313831623464396165666334343632623962653064613939653964626134366165386466
37626536633131363462633961613530366538626562386663323865313238326534636665336539
61396333313466353639303565613638366665353632666361643265336365646361393039663235
36656134323361373862653834613161303139346665373631316331333730316565313633313966
33633737393234336334303937613166366232336664623063326165316330343931316239333263
66376166376665323464613963636362313030366262393637663230626533343435393965363238
39363262343564336536626635383232353038616534303931393135633733366232336363306264
35333338346164316661643832656630393264313135363962333839653766633765323561313163
39656232656562633338633034363234666465643335333065303737323733623836646235396537
32333961633037643263303564626138363330343633633161373231643937323564373439316337
62633265383164356261323161643136626337656137616462366431353234326635353565393438
38303866323664393461383639636162353131353430326533356530313431333437623034666562
62303838303634666261343134656334303734363632643461383033303362316232633038663737
36376362623364346134373335346335363732373563306139613532633033393232303430353339
39306366396365366562336232366135393433666330316331363036363935663562636335663761
30323566303861623239376366303037316362653535323132316238323564383030326339356631
66613762353064663837613666373064363638643739383364353733376432653361356438633838
30366664376438613531303333356265636437393366303333646164373039333162376666646664
37643239346466623830333865616536393739656130613166626464353166336631626162653634
37353838653632356565363465323337346133386431333935386432393164616664663137666334
35346463353433626663633133663463306163346130623331346463656365386466653763363365
65386234393033373532353739383732346634333765663633313961343231323363353831613163
33346339646637616362653862366635363034356534373036356366383966323435326264383634
31306566666266326238353336363064336133653661613362363138666634653933383630633435
35623562353630643739383565393432313961373465323564623665343666346437636533646461
62376338326633323935323639616262626664353931666535653036386630616665343865336564
35336162333636643537376438326433356539613337373932353437333039656231363533336161
39353336363564613531616462353265643234303539396461363830363333366565646332346665
65383531616335613439313637613336333838393439306538373633626337333237333261393765
30383433343964616462353034353061303535373236313833326132633434666162313666633463
30366464626566343966366565386432623266653665343337363535356163333932663535626565
36383664623138316531626230653062356663346565356262343231333538373838396163306532
32663131343263646532303063326132316337646535313030383632313532353839623532623639
34303863343638343666613831313566613361623639346661643066636530383363623333363662
36393139326234373062383233653037353562306535643037353632373366653134613737653362
36616432646130383862616638616466333137323361303265343336656231306530616637313431
30346339363264396336316461343039323433643436333963343562343966313934643632336338
66363133366532373537616630363437626465313262633863646166333562363331626465313234
35343461643964663863373935643733323032393039306332393931343263653130616131663834
64346138376231333438343761353463656362396164373737376436653333643831386262643664
37396562343431346365306639353939313730616164666365376562383035383230386261383137
66653861633861386362663261303832336133393365353530313262363964663163663763383465
33326338666135363762666631613634356432393332643932643534316565313734663136393733
38313963643630393265336361663539336135346132396661333663353130373866353530356361
62643831626630356331633737633234343935623261623164663837643034303665373531383632
31396231386237353165626131626537646335333332663534313739333131646364303965663939
33636332333065653638653164343065383163353961346233353661386632333637383938386366
38333939663164313430623534613832313434396162383865316666353165353130663265666336
38643637316561343238356439643964376639373039343961323464316432353366636531323536
64383433666238346138313235633765353861633731383962353564356333343230333733636365
66336665646165663734383339346565373162643733386532323232303362333235613661303930
34613731616137373961356437306330653362646361343963663461626537383338326230366663
63316133323032626366313563396137656239643736366631346331643966663930363266306461
65646431356634396465336532373338393836353237366339633565313266363731353135316462
30663231343131366635326432386565306161366430383039633461663932343764373631663434
39303261393630303865376465343534343230626230376132653337636263616461313930616338
66353330323765353463326235363731373038336636336664633338346433316563613262353666
30333637333232346330363138356132653937323162393639376238656333326137333535653938
62383563313939633661343239623139336437346635323439363832376539653832663832626430
35323039643431363163616331346336616138336664343361663332333064396139396265333438
33663962376135363431336361646130666133336131363430623434383931333130643934633232
32386432623561616334326630376533343432303537363433356538343866383537626632616565
31316338393235656431313839643661366539303235623837363333313738666163366332633339
38626432396431303963383664326565636335636432653764653337313165626430646463663165
38623134623939623561653731633366393063343061373661663636346362356265326463363765
39646334653265656562396463313865663837333735353463363861393863663733353165653839
37653737316361326663306532616566613236356561383763326437656462636336343031616135
39613063643539353564613233353034666166303734323964313034373537353739623836323935
34326364666438663935313936383938303162643839613463626264333636623563353636303231
34343535303835373235616234323134623338646239366333623465306564663166393539313737
35376664366365333831323865346264613363616331303634633365373865313633303339386638
62613637373932643736613230623634366635383632666530623833396238356233663263333430
36393031326163353162376162656231613333303562306338336138633631336130376639366139
38303737353464326533343663373138373961623333633462393764353131393934623237656263
38653239656439613834383034393536303439613331366362363734386338623063393262346230
37363438393662366332383139386233643436326464383962393135373436353863343462643839
64623437363636393365346238303838633338616162383739383437363730393736303935386631
64393937313133343835326233386166626534626536336630643964326461313930623135333339
38346666356564386238626463346165666264646333353131323834353934316663326562623663
65613034353266633137313663613832633938666533643532303462306161613265323062646436
33386131636561633765623862643833393163383663613362316431373639333663656434373433
65616238636139386635336438373665616161373964643938313236626333643731656634383834
63373639353566393837666136653335316433653764663539643564373636613532386336356665
62373433623537306230366233316665333831343162646134376130363637383563353963313063
36393761663636376230386265626164643830303437633264616232613339333037323236336230
62336331386131613636386531396332323536393839393466376235646231616339343261353134
36316334666533383461326664656666666361613437396235616139646630643438313362663733
35613535373830333038316631373130613333613535623061383139383934333563386635643666
63333333303564353933373063616663316265356665353738323865636439316337666437316163
37636535356566373931663431656565656561626535353531663761366435313338643039666538
33346632363333333864393965616362396631616132646630393164383437373330353861306335
37346630336433643132633433323733616437616236393664626531346264306530353861333938
36313665363963343237633837633739613138633935373466346134323235303536646263353837
33343164323361626661336233303763623139396435353563383031396235323735303437353131
61363562366339336639666236316137393863656439376263356165353637643633343462623733
32623334623339613266646537663763373238386636616332363563366135303763356362326461
33373537663431346233366163656562386636313631383931386636373366616632643064613739
64633239306366306263646463633239613565313838613836616266373966656164333935366630
62633135386231626665373032616363333132303137363434616138643730303830336232393664
63643764333161373539386433333230353630316163653438663637363363646335303535623736
62373264663735356337353264376230313264313739386134393739363937616265623931663234
36336432343161323534656639333930353361363061333035626363613963316634363362366162
30336165343431666666626266623033393131373563393964356434313166383566343663386533
66646162633830376632383531366630343263316562663061333534636431363231356364656262
66316432616530626231666565386137343135396630303933356339386532666632643862633465
64313962613837616266343230363037636632623436326664653231323436666134316333636364
62353535376430646161383434313565303032353336366234313066643438353266666665636231
63313136613961396139343066306636623235663332613366333337366130333638366362356239
35613663366339616564643434636136353737623136303762383437356339376363363236316135
32303961316137346634653132396561643537383031663664613238316139316335303862623530
35643335316532336637383933636433656235353234303064343536373732323030613664316234
63383738393336333933323430346166373966373035316161613461653266666364666339323731
35346636643235316434663932396536376130613262636337666462623661373336656262306330
35326630343261663466633031393566336336383065633665653263373538646634623134373435
31343562366336363563373937333038313436373765383932383231323435663163663832333031
65643937666563376132333133653131326663336661613136363137343835356264306234626236
36303662363837613336313362376662303465356134323031346631363539626435323063393365
66303362336363336638353332633734366564636361633131313434663661643330346661636333
38393933383332376236623533653438303335343932323435356531396539306561373538353331
61346233646430636465643836336131386165613531613435643930346239343665396337396338
66633039363632666331613162376232386539616233623439383539353037376263306436616135
34623536316562343664393065336636646636333438366362613835396431646533346236613161
62326439623335366466393830633762643962356330626262316538653861656162313435346266
63646637336439653963353235623139363532323063316635306330653139633633393638316566
31303739386362383337663962376461383838336535663635613565626432373665653964383061
36386532633431376332653166643336326332353437313561353261663862353464663032663938
37393432373936326233376565396239373435643439366332646634333936643337313535326362
31393632323661333064353739386663326136656131306363343265323138326435326562316637
64313735646465646636333533666632663235633234643730643138643661643931663465663864
37333638363439663030633863343765366262353839323332343138353962663731333661303465
39636531363131306439656566653639383039373862323931386262356632366635393636663862
31373437383863323861626137616631316562363632356139316263633163623938376536323236
32366562396336663263653936346139623363613838613063336136386435303263363162663266
33633863363134303365376538653162633838363863643766343336646361303330643038346564
61666232663264336635303336373731633734356637323738363466336430386134
