$ANSIBLE_VAULT;1.1;AES256
65613466353664336364656266316431353738343135343835393035323966373761353132373936
6265323737313637336366653534613839383862346639310a326432653661646566306431366162
34316261666236316638656131616233333964343331396230653033326139653535376265306565
3730356439303961630a643138393039303764393061303834626232346534613635393937323838
32633331626566643239663264306138376536643631306563663030366466643263376630366365
33393033336466346431613139656233386639303062303633363534626536623833643530303963
37313430306565303333633137346366343930353031386330306638353131646665386264356236
36356238353138306563613834353237643931336561386339373635633835396235363935613433
35323139636131353764636133653666626666393435393665386238383665663730666265376138
62316132383132373130346239613936396435393038326563323165306133363437303164663737
38626235303832383764313336303366383830643637626431363765323066323731346333333431
33326137383935393332373563323564366236363330386264613936626535666563383162613638
32376664636237616331653266313231366339623834336639376565323037333037303931326530
30656136376633343730346530333139623666363264366338323836626665663130663338643538
38326433333534356565323663356130303232653362393735383833666430343366313839636464
35653836653336353430393764323934333531303266623064313232663930343966643638353765
38623364383762366633663230646338396466616161373261663564316533653635346232303034
65313064656630633937366139306536373064376337373738633233303534613865343434653939
65396463383964646333323737343766623434643863306635396635326361373338353163666464
31396637666235373131316232393862353561356464323330303438303132363139323365313436
33633633633138386366363465626237663464663532653732626338366430656532333537336265
31346437343234303765316134303665303933326336396134666664613836643037306233633535
38306366383762623435643062306361643936626165626334343963653761373839626164623531
39616465633163363038313638393430333330343165643962663361613363316461663066623835
31373463376136643265656538646131306165383736313137643465373230363162636465373365
30373039353930343761656435303762323435646438363065346430323761353239663233646537
38333263643539383937376565353565643261636331393465616233313163376137393739663461
64353537653230646336333563643139366130633931386366623766636535666461633965613234
33643136333038616232646434613864356365333163353965663633363131356665613934303263
61316435393166613632626531616230663534636164316438633262373762383864643262666432
37623639613365656464393535623562666538306363303862633664646363326137633231333134
34393164343938343937636533656430346236373637613030306534346235303338303332316432
30626234353165313464376564363536653835336561396432316331343030353632613461353666
31346130663635333736393939363265366630346634363034336635396564633237653032646232
66376536373463386332643761646566356330306366386232373439663337326232313566643032
33313665386563333138396365316665343034646635363635626465396433663738356561326365
65366263356664666663393431306532366638306362653936313163646664313733373833306532
62333636663963363338626164373566646166336133623265373133363035353665356537623564
65646535343366626435383938323762633130623337323362323834316265363239343362643732
63396461653262393363376231386665373363323735653962366564623334636330663962386234
30323138656165353630623936343062633265643239353162336663626363646562303061323834
62616431386161383564313962393638643861323134613830653166663864666564646334656534
61393661636233656233366635366532353438396530643236323865656433353862333638386139
61383061313865663533666439343738323464623864363031396236313763353665643565663933
63333961633635303765323861323032646634613464306432623636656236386665616436653461
33313236626139313635626231303835336662666630313634323861663237363766353564393836
61653163333736636261653465633532646135316334653230653035646637656262366539646663
61666639613839393133633563393763616365303336356435626437633030373864613139383031
63656131303939316632343930636164626537353939326334393061616137313431343265353330
63383532376536396162343464326538623536373562333862626565653439623837623634616638
38363235623636376138336136316136646337633432343837373966396666346335376236306362
32366431383831623563333936386562633036616564323631363637386434383530376135633439
63363234663337396337613165373639636339626564626334333334316332666662383233366362
64386334336132356563303130323734333764356365663262326162343063316432363535376161
35656163643765326338343266356431393863613664383334383838616635393864333762306530
37613462613735393233333238656633373338653161373937396635613763336231666666303031
30386232313237643830313633646462366666333864653730316434646135653738333239636237
36393736663033623861313935383061303262313461626539643732373762383939643962623431
39373335386661653263613762363137323738393531396237316239323739353838313631643239
36313533343635326137636539333537656363323331663766613336623033343131313737343137
38646564373131376132333134643130346338653062333430623831363530393530633035623434
36666263643165663064353631616232633466373063663962666631643033656366613931316666
35326163653661373435613138303563333762656236363138346162653364383365616430636337
32663335313864386332613235393764393161386139653538626532303533363331383366666632
66646635623963373461396331333233323966396565336635336531656664623631356130646232
37343030643866623031663765373737333362666364353535636532616339666334643833653162
39373633666662393531383231643836646635386661306361343966323537316230326263393235
64323232353934373765316263303562653434656633616261323735346330383962613938356263
31323365353164396636306636626637336538363131333832336362653530333263323539363836
32623436366365383766663862316534343030653835376131363161653466333263613166386263
64343431346138306561373465326331393038643331633236376164616539666132643866323438
65336638626565346437626436623866396332666563663261333335643431613761313863316331
63313665376464323934353237303232356538643831393935643432356131346537323964666637
36643065316333386261376639616162653462393465636239313234653161613638393366393735
31336133666161383764313839386335323738356365323139646564616463323037396639346166
66333035323438386235313163386633323639636135616636306134363637333562653363303632
31653238363764323933316133366565636664656439303438343534616632666437366663363339
61623236333933363061633164346238313333376136316236393564333266663334653539333966
64656362656437653763323064323163383564363436313437336563343038363331306634616631
39303537303039306162366137356563333832626138393637313366353766666361663061356335
32666663363661393633393736303330613534633262366362653662393963383935643337303438
38316130386234303335616535393234303865383263656337653832373437633632626635393637
37313462323238626334303066653231373862313533363231336334363765623839653136633234
62663965323662393665666335623862366366386137646238623732323766383135316236356538
34346332333034376430353261313732333562636463316563663465346233643161303932343631
33613638343637623832393533643539386131383463643430313265653130336364383465633862
65363031343563623434383862653631396264396335383664393536366364646666633039396332
65646332653734386531623335336533326338323732343661663864303864363833383430376364
35313162623737303733633265396139303661316633623133346465613665366630393466363934
66613331313665623565336365636165626533343736333463363165303537323266326636393033
36336364653566636639613433613831333233333135373564656334373066646233666564636461
33323632343764623962316461626236613031333238653262643935336530663033626331383437
34346333656264333535356332646531303034326432383331303230636237643562616562613336
31383136373830316137313931303137303135396231346539326433323030386430316237356432
62383835653339363662313963626633333466373335346465363466623837363161613561336134
30303834396236393539353234333833373365633330376536383939373536303761363731383263
38336131663235663033373236373965636565353161613562306236633237663139376637336365
36343939306230313637393431633436383162386336343264663530353832636366643862663332
63303366663039356539643636313264663265393762326537616161393263356130363662303564
39363136656232323535326536613534353665303830646561376639633261616233343563633139
39366634383962643961663835396537613663393062386361656331643664353537623966353463
33393066623833643962336333633732633331646131656439663738653961373631623734633162
31316632636430306466306166653431363765653435356235336339663036383261623739316630
32326362626637616265363335393836646265613066666634643430383633303161643839663666
32336633363530353365363533623335633030326236633661313333363363303933343261323337
62646331663337613266636238353961623965616230396237633933663235613964383235366132
66383165386165336266306162353931326362333130383665656134623238623530646130333836
61313966326261643039663266653165386539323537613966333638663461316435663637376465
32346231626264396330343466666164653534626564633666366135396466333033633730373134
66633230346265343639623761623731663162653633623764363337626265366234313534333833
36353264643134323933343163663264656465356165646639616265623436373062383735343463
36393435323065333936313761333739316239633134323938636538626234396431613532643834
66343131373364386132303737323463643537623239383334383532323835306265386236393064
65633435306231653037636465326230616535333964646433653538316139306339656263616231
65666264333065626236313864626630353862636433633334366661393161353435366465633131
39383536643865363463383665363832613133656136663335316533333332656637626132343239
61386633636534383365303062373734363631353330383833343935376637353530623031353132
33633638326361623964653031366430353364613836376230393230386265373731343766373236
30383331613564373566316463643238623738626637663364323666656133613262613535303962
31653132373938656562336339333666626239333565656638376266626363383261376339396230
65323438373934383036393266663136643839313661643135643962336161393534306637346332
66363733653939636335643765303433666539636339613164336131313337363165393865366531
63343230643234303866363638666539333366303434633439666665336366666639373532663662
39316165633139383333353163633566623362363234383333343737356532373461346535373537
39383239333734613664393537343931613130643464663466313864643337346635306137353935
32363065363731303235666130323337383264373632656564373962383163316463633465646266
62356264323061653766626132356165626266336230366262333264633435356239376537366339
31623665376466383864323238636132353534363939353665386539663938373566343839663634
33303939396562313164623735346238306361306138633566613565326461343830636338316331
63663435653064643535663632383062313261643638626130643237396136396464303862376663
33346237393433363965653666386138323737346637383563313961313532353066373630613861
37643264623734326532656438353239633631333834343830386463663735346332386565373634
35323230663966343034636234303463366438373332613964303130373362363833386163303738
36323864363233373562626461626363356335366364353439386631326666643563356334663534
61626361323830323331323031636332613664666336373166616638343734323432393132636431
65653934396465623463626639353365656434393930333737636135333532353533366665616666
39396266363762383433343330613765643261343630613934396335363163646366653163326265
33656136366230653730613838613539656362326564663636396632643663616138656132386561
63326161323334323764356565646633613765653263353036353162353063306535373339393561
34643963616163616431336139646432626134393530366236633633653861373261343933646630
39336538373535363937373232363238363337663333336331303763643762336436303665616161
35616532613361643832323637343564383262373465353266323564373730663433393736663032
30396130626535343235636336373437613432313731663231663364383062343831303231666631
61323566323732666639396236336433363564666464666536306235313432353536626138633430
61646430383764386430333565303933623033656664373964613664656330623264643165323261
32653463333432373462303135646234643665323239633231346133313634383730376232373039
38636633326137613332346133643762356336316330333537383830663565393633313239323338
63386530303532656239653038623661623731386464383739663235386136653162343564303435
65643961626436393730303837303736623366633865396533353736363036613761333762393136
35666133346432306434313439373034623730396462373263653133636631373435306631616638
34623361616361643633306537356163626230666563646562613236396166333537656266316361
30303939626136383434376339316431393932313762323633316432353062346361626162393430
66353633626532383439313736663338643437393666626431656332353035323235353565353163
33663938323836656566626564363130353532316634343365333038333864303961356631643134
37623131353664383936366337353866613264663165316463373365646363353537656237626234
35633562356138366137306630633031366535396663646166383636643834346238613539306133
65326234383039666666313766323734636138373332346131656435616265633935323730363530
39346439366166346430323431376465316630353536626564316564366237373030373536376637
33636264326433303138313161666230316464333762643934306665353230326632346435376631
64303730653664383633623066613863663733366438306231383935343335396364313931386238
63666437383632343639373237316165343139663566623930616465303037356361316662313662
31653765323164633366363237306563633736333663356637316361313734656430623833316166
38633132363635323035666436373465326137363364376439386565616564633363653933313261
32386335386131316438313233333739663337386431383262396238633863626634373962626539
62326663383363636534633335663737613537633165346264656163616130613066376361653138
32373739393764643361656661306339336435353764323865663038326437666434656230396566
35643461366565366161666239323736373732343762663566623664346335386231653036373661
33323332323763646434623737613063383638383139353638386362396263623332623263623164
31323233326539393566323635373063636432303931656536316238656634333538383731353962
61613266333138316339613161656661346663616231393563336637336431643839303362356337
33353563306631393238333738643334393535326134323533626634346562336461373566326564
39313139663461646666363537636137323462633833656432616364323537313331656333616236
64386337626332633164353738353338373233393165636431313733626463356564
