$ANSIBLE_VAULT;1.1;AES256
30373366373663626565303361353931313761653164363663613561303333623132343134343231
6431353636643132363438313134633463363036383762360a653265313561396434666133626163
61623634313361346137333237323435363038393565646434636139653238376437386333393336
3361653363656136380a346637393038396137373636303762656264356565623362626536303066
63326166303234343436316636326166646334666335396566313963366530646136643734333935
30643833393636386137353933623362383132303939633062303963326263323463386665393435
65626536303938316161393033316632313631646161373633366463373237613562306632633861
66303765663033633061323365376565343037626466313961636564623134643433653939383065
36343861656235646531326661323136386165666265313439373932383638653537336437326330
64613266656538616661326365643736666439303539623534376338366663366133303834336538
32653039323862636239356263663339353363343234653764643831363063396530636237343135
38663132316135383035623031396339323633663137373136313761326537353938346161343634
62666632326362616638656430306565623764313365396635656466383863363561396166323534
38666531616561623637666231326532363061613832643433663535306365336634323834373461
30313637353931303932373861363639656336303036626663313062353362366361646563666631
36333735303465656364306434326466326230636564353535303039363435633935663434623461
61626234663363633338663330313739343334636239303835643236303739636333653434633266
39363265333363613566313432643564383766666464636162346631376162613966376437343237
62653366326361653931613638386536373331333930623038333933333439366365383639353963
61333638363466653736323631626338623764396237346365643835376434363663323262326166
61383461666262613032323632396432646236323230653161623061643161343936373462363331
63383839353032376336613732346366313562316231643237326362353539623538356266623838
62646439616136373935396137306434306339336161326634646434636464366262636633393862
30306464646463353835313137333934653162376635393061663433386434333838353739643262
63623934646562383930663362393466313831343738313336613935656664363934306363366134
62366435656238623461663638366435306636653638306232663766616630333030353637383636
39303039653466313764313536396638373335623236353132316435666165626565636136653833
35663263316239383638303233626265383437373861656463303038393439326136386430663866
32396536323937643538633066323536306332313663336633333563653036303665376364653538
61303032386334643032646263383461323536633761613138663363356561323034653132353935
36633332623265383831633434363866393063353836643339313062623662633534383238643062
61316438353937616333336161363731343563326434626262636262396135663762363232636236
31386362353634656265333639383238623538343333643665316566313837333066623531313039
37343263643235326662643735393564666432316637643465383532663765363939333465343065
36616134346364313130353466393234323335356538333636303163313864346534373963313835
30343339626639363362396631373834313462373764353165363131616537613166633665393636
38356162613235313732663434366465373766613735356365393433383938363338303032303934
63386530333034666638626230343539663766626536613132393163623330636666353462306133
37326461373932663835343730633264366232306364353139376536643837656565313462383536
66326531323363633165316130393437623264613235616338373563333234313432376134333336
63333730376632323533383032626536326339393538353138353639366663343338353264653238
66323437663631336462343035383739383861343031303365636238353936326439373863376431
30653664366135353734316330643935386636373762306531316431643964353733663439303538
36303162333437306333326436633465313837346138373766363562303438633532366461373935
63353438613562393964363863306366366130653133343461383636646266373763306233376334
35393930356631356366306537323930643665356530316364666632343039396435346537326333
62613261646362653537636131386239633638313830636235323062663539623165343037616133
61356166363034323463616139343336643536376331643863663036633162323830303638633862
31623839623431346136626631333363343866373364353661346336383965346137613235653865
31303739346236343735646536393564353063303234663261346363376438643838643033663266
62626630373761646366306363353261366261303266626232386536656337656662363562353466
33636536316561613433666461633864333533396330653564656633386162326533336336323138
62663037643065313134613238393131366238333039393735386233343539353638326662376563
36646261386633383236666163326338653165653166353933393731313035633534666335393562
62393465383932663133386663356362666430313665313661626531643764363033643531633665
31303733643139633662323630393635383130613664633635663534646630383862633838333737
30336631306435393566636439353331646437353531336461326137336161303864343263643430
34633164333661626566366466303632613136323036616265643166356530393130306666613737
66343039636636393765353132663162326134393931313462313165616430626461616636326162
31623338616262626562333232336330326462663864656232623831363433343939356634323364
62353363663237336633303335613537313731333264383437643434616662343734643266393237
36343033623236643234383163623764316361666639393736643937623062653836323266303135
39646335386132303164376632313765623235626433346566313563303333333339666433326132
38343937353865383361303331346232356339666230616266663430396231666666643632323236
39633939353539613931366337653664323466663465303235623136336230306531613230396535
39653132393462396336643630616234393637623631313634643433363065313034623265336562
66653632613333663364626361363132653238393637643062316630633432386132656431336636
34633264646265643061656333623639333461343531653534303233663736313737303563643963
65653965356638366237323136396238633631623432633762393238396565303466646136363464
33353332613763666530303663336235343463393839623938383831616430383964643436646134
61396561643737333137376632363638353233393235323936356530666235636665356535313038
32646635613335656638613265313931383861356666373966616639343139616332343437363739
38643765306339313630303061393831386663643030323465636233313061623038656237356463
61626138333161366337343634663938613731316663376633323237643764313635336263613332
63333863303831396136653963333930623838613762393866346564393334643932326165383334
37623233623065643165613034643434383438646531356439333131636338653962656263656339
30303561666232326136663936313066616564383536306130383030343930633365353433633639
63393735386235333864393065393361656666366561623163336534666233313533643336323937
30646464633565636139633631313532623062323061333061353635313739643162643233613432
34383666336436623037376339656136393834616139663936636237393637643663373163313566
62346331613232663139343933306162633139663834346532316265393938623937666533373038
31373138343466663430323030356634656361363436306539356232353536316263613436393835
32646333343266633663666665373662326562386466653232363438646637613866353736373936
33616661633537333262643330376263356337663539633839656138373335353465623364633139
64616636623361663435333932386231336337323465663265343731393935383636383139326661
31336462373434633136666438303539646636353535643135313562656664616662356637376338
37303036303139636533313738363030373239616430376332346638383363663766643533376434
39626535306531633365303433323063303366396433343863636538663166346231356133386466
64666539363130663262646539376631363231643434643135356336376635336439366637663530
37363463616637386534313936643538393161613833363438316332386433653162653432386535
37613133643538383966316366653536393733633036646536316437323438653137616365663634
31343130643635613865373366333535366362663863666334333738383166316338386438613338
38376231313135656531373634623133663564646430613362663264333136633461383264643663
65323034643636323939386136336137313334643139373936373561313665663163363637643966
30326231356561336365393064336533373639366364343334393733313738343263373465386364
63303537613238376532616666323533346364396232326630616563323632343433366534383839
32326537346663323663303734313235323535613535663338633461343963353265666230363333
62396331666266656637623363636162643732663031636264363463663339353031343262623931
30366236623738393162306131303863326432636564393930663963663233623333623862373766
30633538363365386166343263626463353864613966643339303263373539623564323330306131
65303962363561623038633763613165396431373837636463343962346637393437393665356665
65613139633234646361303237363361616135323136663039343337636462663136343230383235
66393266306461653037643261626266343831653035653930386466623462333136613436616364
39373866636635363832346639646563333833643036613939343238636535346661656130366531
32666339333164333031386264626164616266623832393239393364386430386161373230373336
39626530643662313537636330623164316135376365656162353436643361636662336364636239
37623133323831653230366565633536386236353634643737316232656633653662396235643761
36346631323162616234323962656331656162303937626466653731396333306334373336316139
62393133623339656666636633306636363939346230373632666664623830336633623363323737
31643239313139623861363862346466366639373066303639333032333338623238616564623630
61643534363230383732663661396664333739633466386237656337636337646137613261666665
33613731376266386562363165343836383162316639613361333037613733613130626162333732
32303063613431386432643830636133383533313432366434303737313339626131363337653030
31366161383261373962353035656537616435623962633235383166633364333433306662393666
34333634303539313633623536663062373938636636303733623137386331616336613337363733
35353563353766393662653332326235373362626431343436336164303530633233613636363662
35336134373663383236666336616137346561303033303132616436653964663138663530393761
34363737663132616238653035313563363039663061313534353434613663393163333565363261
64356236313063633864303265656432333237333930636437666639303235373266383431633034
39303739326163653334356166316561376435623765653039363165363538643534653662323738
64356535373838653664323966383762656332323266303031656534646235363461333663633234
30343433393835383539613262383964393733303231333961313861616638323237663137343236
33336133373565613238643538333235316166326332333133653035346632653464373037623930
65353938623239346261633430386530363539356236323437616537316437383631333863616339
32386637313538613533313836346131313235636332376630656137633735643730636134333331
34323435373035346636653836376464313161353532326538343165653037393164616635626335
35353837313131373335393937306566376331343437663639343730616639316434646663613737
37653764623832366366376566623063623765376430356461376236626132373763313138626537
64396262313130623366656231383836363432613731326436383462633535316437383138623062
63616133633763323934346638613936393030646563306336616362363131613866313363373666
62373936336164656638633235666137653433333362356238613239656461656331613461643335
31646663333164633562636462306436633434346434613065636634303438633664623633393037
31323331623735366539306465636531663739653764653638333065353039643037626564313530
65366536363535376333666262633139613363646438653831613834373064633762623631623832
62343166353463363934636365313635313661353363366431383935313233653563653332333635
36393866323032353333643737663339343666386339663632376133383433356366666232323566
33346161666233306634303030656663666661393631316237666563333037366238343533653932
37373762363932323934343639303639323162306331303830343564336132316364363663303732
34373762323130656165613661636533363062333166653731656565303439633130636162363832
35333564376236613763353963363166626632303639663834363862613639383831383566616165
30646663656337626364646232623632656639333439326664616164303962343333313061333433
62363664363133393131333030356235343630316432373838396262326236343061663662383661
63356333386263373065323232333832303065643563356330336531616461623363323230373165
32336366386234353430386136323133616138626633303536353938656263636332333764623735
36643165613831643161323764333833333238633533346566386338326663646533316561626433
61393864376165303734303465346438636436316265626263613737303336653364313534623338
35343338363962303964666230623265313931316537326638373135366163613636353164326636
37323762666562343732343331366665626431383134626231663735613130666435393462613230
66346236623531363431356439373035393638373437376133663766393539343135616334323739
39623732663431386234623939343238643533666263393662663731363131656163393634646234
32303131656565313138366338643261353438313762373662373566633036353330656266383461
63626130623934356237626564353965613966366530623736616261376538643366386635643536
63326435643031303563356138396336613665626261653834626261616439313464316437626564
61383930633165306635373431343532643930383965646666643034343733366330333137353965
38646639623938653565393738383938616231396162323135393430633263303238623263353064
37356164653333643731373333336133333237616165646263366635613164316162613538376666
66393065303335346531386138356339643939353436333936626139393438653163656462643534
64326631363065353865313462646538663035663933633936386639353230326466316536626464
32363232346664616133343730373135393530343033363038653130643736616535613162306663
64323231623333653330346236666264303636623966663461653061613336323161626162376237
32393864326263363361393731633838316263636233386637323439613662313731656437363061
35356365343466393835636161373065646130336365653639316430346538373531363133333963
34396637316336393935323261646664653733653830366466386662643639636163326633623431
64336434386633316430623065623565616165643961346134383333326333633566616162323337
62313963363464666461313332616161326133336530316531616531366531363231643434373430
63666231393937633462323061346233616131633031653764316665313065346238376535636637
34653234363733366663396164613837616163326461306538303436653361653664353530636638
64303435306631343561346237373063346266353264343135636463383834376463383337626631
31613536396332653639646565383964343261333464623962353039303830376235303337363134
31646563386261336562353937346231376535333565316464656665613931386162313661623930
39633738303964383761646664383366626532303365656333303337373062333533326665353261
62616333613331366637336633646566356461633938643163633066663333643137663537656466
61633931623166323931366565636533636636623437373561376663353264643063
